wolf->map[0] = strdup(
		{
			{2,2,2,2,2,2,2,2,2,2,2,2,2,2,2,2,2,2,2,2,2,2,2,2,2},
			{2,3,2,2,2,2,2,2,2,2,2,2,2,2,2,2,2,2,2,2,2,2,2,2,2},
			{2,2,2,2,2,2,2,2,2,2,2,2,2,2,2,2,2,2,2,2,2,2,2,2,2},
			{2,2,2,2,2,2,2,2,2,2,2,2,2,2,2,2,2,2,2,2,2,2,2,2,2},
			{2,2,2,2,2,2,2,2,2,2,2,2,2,2,2,2,2,2,2,2,2,2,2,2,2},
			{2,2,2,2,5,2,2,2,2,2,2,6,2,2,2,2,2,2,2,2,2,2,2,2,2},
			{2,2,2,2,2,2,2,2,2,2,2,2,2,2,2,2,2,2,2,2,2,2,2,2,2},
			{2,2,6,2,2,2,2,2,2,2,2,2,2,2,2,2,2,2,2,2,2,2,2,2,2},
			{2,2,2,2,2,2,2,2,2,2,2,2,2,2,2,2,2,2,2,2,2,2,2,2,2},
			{2,2,2,2,2,2,2,2,2,2,2,2,2,2,2,2,2,2,2,2,2,2,2,2,2},
			{2,2,2,2,2,2,2,2,2,2,2,2,2,2,2,2,2,2,2,2,2,2,2,2,2},
			{2,2,2,2,2,2,2,2,2,2,2,2,2,2,2,2,2,2,2,2,2,2,2,2,2},
			{2,2,2,2,2,2,2,2,2,2,2,2,2,2,2,2,2,2,2,2,2,2,2,2,2},
			{2,2,2,2,2,2,2,2,2,2,2,2,2,2,2,2,2,2,2,2,2,2,2,2,2},
			{2,2,2,2,2,2,2,2,2,2,2,2,2,2,2,2,2,2,2,2,2,2,2,2,2},
			{2,2,2,2,2,2,2,2,2,2,2,2,2,2,2,2,2,2,2,2,2,2,2,2,2},
			{2,2,2,2,2,2,2,2,2,2,2,2,2,2,2,2,2,2,2,2,2,2,2,2,2},
			{2,2,2,2,2,2,2,2,6,2,2,2,2,2,2,2,2,2,2,2,2,2,2,2,2},
			{2,2,2,2,2,2,2,2,2,2,2,2,2,2,2,2,2,2,2,2,2,2,2,2,2},
			{2,2,2,2,2,2,2,2,2,2,2,2,2,2,2,2,2,2,2,2,2,2,2,2,2},
			{2,2,2,2,2,2,4,2,2,2,2,2,2,2,2,2,2,2,2,2,2,2,2,2,2},
			{2,2,2,2,2,2,2,2,2,2,2,2,2,2,2,2,2,2,2,2,2,2,2,2,2},
			{2,2,2,2,2,2,2,2,2,2,2,2,2,2,2,2,2,2,2,2,2,2,2,2,2},
			{2,2,2,2,2,2,2,2,2,2,2,2,2,2,2,2,2,2,2,2,2,2,2,2,2},
			{2,2,2,2,2,2,2,2,2,2,2,2,2,2,2,2,2,2,2,2,2,2,2,2,2}
		});
	wolf->map[1] = strdup(
		{
			{2,2,2,2,2,2,2,2,2,2,2,2,2,2,2,2,2,2,2,2,2,2,2,2,2},
			{2,4,1,1,1,1,1,1,3,2,1,1,1,1,2,1,2,1,1,1,2,1,1,1,2},
			{2,2,2,2,2,1,2,2,2,2,2,2,2,1,1,1,2,1,2,1,2,1,2,2,2},
			{2,1,1,1,2,1,2,1,1,1,2,1,1,1,2,1,2,1,2,1,2,1,2,1,2},
			{2,1,2,1,2,1,2,1,2,1,2,2,2,1,2,1,1,1,2,1,1,1,2,1,2},
			{2,1,2,1,2,1,2,1,2,1,1,1,2,1,2,2,2,1,2,1,2,1,2,1,2},
			{2,2,2,2,2,2,2,2,2,2,2,2,2,2,2,2,2,2,2,2,2,2,2,2,2},
			{2,2,6,2,2,2,2,2,2,2,2,2,2,2,2,2,2,2,2,2,2,2,2,2,2},
			{2,2,2,2,2,2,2,2,2,2,2,2,2,2,2,2,2,2,2,2,2,2,2,2,2},
			{2,2,2,2,2,2,2,2,2,2,2,2,2,2,2,2,2,2,2,2,2,2,2,2,2},
			{2,2,2,2,2,2,2,2,2,2,2,2,2,2,2,2,2,2,2,2,2,2,2,2,2},
			{2,2,2,2,2,2,2,2,2,2,2,2,2,2,2,2,2,2,2,2,2,2,2,2,2},
			{2,2,2,2,2,2,2,2,2,2,2,2,2,2,2,2,2,2,2,2,2,2,2,2,2},
			{2,2,2,2,2,2,2,2,2,2,2,2,2,2,2,2,2,2,2,2,2,2,2,2,2},
			{2,2,2,2,2,2,2,2,2,2,2,2,2,2,2,2,2,2,2,2,2,2,2,2,2},
			{2,2,2,2,2,2,2,2,2,2,2,2,2,2,2,2,2,2,2,2,2,2,2,2,2},
			{2,2,2,2,2,2,2,2,2,2,2,2,2,2,2,2,2,2,2,2,2,2,2,2,2},
			{2,2,2,2,2,2,2,2,6,2,2,2,2,2,2,2,2,2,2,2,2,2,2,2,2},
			{2,2,2,2,2,2,2,2,2,2,2,2,2,2,2,2,2,2,2,2,2,2,2,2,2},
			{2,2,2,2,2,2,2,2,2,2,2,2,2,2,2,2,2,2,2,2,2,2,2,2,2},
			{2,2,2,2,2,2,4,2,2,2,2,2,2,2,2,2,2,2,2,2,2,2,2,2,2},
			{2,2,2,2,2,2,2,2,2,2,2,2,2,2,2,2,2,2,2,2,2,2,2,2,2},
			{2,2,2,2,2,2,2,2,2,2,2,2,2,2,2,2,2,2,2,2,2,2,2,2,2},
			{2,2,2,2,2,2,2,2,2,2,2,2,2,2,2,2,2,2,2,2,2,2,2,2,2},
			{2,2,2,2,2,2,2,2,2,2,2,2,2,2,2,2,2,2,2,2,2,2,2,2,2}
		});
	wolf->map[2] = strdup(
		{
			{2,2,2,2,2,2,2,2,2,2,2,2,2,2,2,2,2,2,2,2,2,2,2,2,2},
			{2,3,1,1,1,1,1,1,1,1,1,2,1,1,1,2,1,1,1,1,2,1,1,1,2},
			{2,1,1,1,2,2,2,2,2,2,1,2,1,1,1,2,1,2,2,1,2,1,1,1,2},
			{2,1,1,1,2,2,2,2,2,2,1,2,1,1,1,1,1,2,2,1,2,1,1,1,2},
			{2,1,1,1,2,1,1,1,2,2,1,2,1,1,1,2,2,2,2,1,2,1,1,1,2},
			{2,1,1,1,5,1,1,1,1,1,1,6,1,1,1,2,1,1,2,1,2,1,1,1,2},
			{2,1,1,1,2,1,1,1,2,2,2,2,2,2,2,2,2,1,2,1,2,1,1,1,2},
			{2,2,6,2,2,2,1,2,2,2,2,2,2,2,2,2,2,1,2,1,2,1,1,1,2},
			{2,1,1,1,1,1,1,1,1,1,1,1,1,1,1,1,1,1,1,1,2,1,1,1,2},
			{2,1,2,2,2,2,1,2,2,2,2,2,2,2,2,2,2,2,2,1,2,1,1,1,2},
			{2,1,2,1,1,1,1,1,1,1,1,1,1,1,1,1,1,1,2,1,2,1,1,1,2},
			{2,1,2,1,1,1,1,1,1,1,2,2,2,2,2,2,2,1,2,1,2,1,1,1,2},
			{2,1,2,1,1,1,1,1,1,1,2,1,1,1,1,1,2,1,2,1,2,1,1,1,2},
			{2,1,2,1,1,1,1,1,1,1,2,1,1,1,1,1,2,1,2,1,2,1,1,1,2},
			{2,2,2,2,2,2,1,2,2,2,2,2,2,2,2,1,2,1,1,1,2,1,1,1,2},
			{2,1,1,1,2,2,1,2,2,1,1,1,2,2,2,1,2,1,2,1,2,1,1,1,2},
			{2,1,1,1,2,2,1,2,2,1,1,1,1,1,2,1,2,1,2,1,2,1,1,1,2},
			{2,1,1,1,2,1,1,1,6,1,1,1,2,1,1,1,1,1,2,1,2,1,1,1,2},
			{2,2,1,2,2,1,1,1,2,2,2,2,2,2,2,1,2,1,2,1,2,2,2,2,2},
			{2,2,1,1,2,2,1,2,2,1,2,2,2,2,2,1,2,1,2,1,2,2,2,2,2},
			{2,2,2,1,2,2,4,2,2,1,1,1,1,1,1,1,2,1,2,1,2,2,2,2,2},
			{2,1,2,1,2,2,2,2,2,2,2,2,2,1,2,2,2,1,2,1,2,2,2,2,2},
			{2,1,1,1,1,1,1,1,1,1,1,1,1,1,1,2,1,1,2,2,2,2,2,2,2},
			{2,2,2,2,1,2,2,2,2,2,2,2,2,2,2,2,2,2,2,2,2,2,2,2,2},
			{2,2,2,2,2,2,2,2,2,2,2,2,2,2,2,2,2,2,2,2,2,2,2,2,2}
		});