1,15 1,15 1,15 1,15 2,15 2,15 2,15 2,15 2,15 2,15 2,15 2,15 2,15 2,15 2,15 2,15 2,15 2,15 2,15 2,15 2,15 2,15 2,15 2,15 2,15 
1,15 1,15 1,15 1,15 2,15 2,15 2,15 1,15 1,15 1,15 2,15 2,15 2,15 2,15 2,15 2,15 2,15 2,15 2,15 2,15 2,15 2,15 2,15 2,15 2,15 
1,15 1,15 1,15 1,15 2,15 2,15 2,15 2,15 2,15 2,15 2,15 2,15 2,15 2,15 2,15 2,15 2,15 2,15 2,15 2,15 2,15 2,15 2,15 2,15 2,15 
1,15 1,15 1,15 1,15 2,15 2,15 2,15 2,15 2,15 2,15 2,15 2,15 2,15 2,15 2,15 2,15 2,15 2,15 2,15 1,15 1,15 2,15 2,15 2,15 2,15 
2,15 2,15 2,15 2,15 2,15 2,15 2,15 2,15 2,15 2,15 2,15 2,15 2,15 2,15 2,15 2,15 2,15 2,15 2,15 2,15 2,15 2,15 2,15 2,15 2,15 
2,15 2,15 2,15 2,15 2,15 2,15 2,15 2,15 2,15 2,15 2,15 2,15 2,15 2,15 2,15 2,15 2,15 2,15 2,15 2,15 2,15 2,15 2,15 2,15 2,15 
2,15 2,15 2,15 2,15 2,15 2,15 2,15 2,15 2,15 2,15 2,15 2,15 2,15 2,15 2,15 2,15 2,15 2,15 2,15 2,15 2,15 2,15 2,15 2,15 2,15 
2,15 2,15 2,15 2,15 2,15 2,15 2,15 2,15 2,15 2,15 2,15 2,15 2,15 2,15 2,15 2,15 2,15 2,15 2,15 2,15 2,15 2,15 2,15 2,15 2,15 
2,15 2,15 2,15 2,15 2,15 2,15 2,15 2,15 2,15 2,15 2,15 2,15 2,15 2,15 2,15 2,15 2,15 2,15 2,15 2,15 2,15 2,15 2,15 2,15 2,15 
2,15 2,15 2,15 2,15 2,15 2,15 2,15 2,15 2,15 2,15 2,15 2,15 2,15 2,15 2,15 2,15 2,15 2,15 2,15 2,15 2,15 2,15 2,15 2,15 2,15 
2,15 2,15 2,15 2,15 2,15 2,15 2,15 2,15 2,15 2,15 2,15 2,15 2,15 2,15 2,15 2,15 2,15 2,15 2,15 2,15 2,15 2,15 2,15 2,15 2,15 
2,15 2,15 2,15 2,15 2,15 2,15 2,15 2,15 2,15 2,15 2,15 2,15 2,15 2,15 2,15 2,15 2,15 2,15 2,15 2,15 2,15 2,15 2,15 2,15 2,15 
2,15 2,15 2,15 2,15 2,15 2,15 2,15 2,15 2,15 2,15 2,15 2,15 2,15 2,15 2,15 2,15 2,15 2,15 2,15 2,15 2,15 2,15 2,15 2,15 2,15 
2,15 2,15 2,15 2,15 2,15 2,15 2,15 2,15 2,15 2,15 2,15 2,15 2,15 2,15 2,15 2,15 2,15 2,15 2,15 2,15 2,15 2,15 2,15 2,15 2,15 
2,15 2,15 2,15 2,15 2,15 2,15 2,15 2,15 2,15 2,15 2,15 2,15 2,15 2,15 2,15 2,15 2,15 2,15 2,15 2,15 2,15 2,15 2,15 2,15 2,15 
2,15 2,15 2,15 2,15 2,15 2,15 2,15 2,15 2,15 2,15 2,15 2,15 2,15 2,15 2,15 2,15 2,15 2,15 2,15 2,15 2,15 2,15 2,15 2,15 2,15 
2,15 2,15 2,15 2,15 2,15 2,15 2,15 2,15 2,15 2,15 2,15 2,15 2,15 2,15 2,15 2,15 2,15 2,15 2,15 2,15 2,15 2,15 2,15 2,15 2,15 
2,15 2,15 2,15 2,15 2,15 2,15 2,15 2,15 2,15 2,15 2,15 2,15 2,15 2,15 2,15 2,15 2,15 2,15 2,15 2,15 2,15 2,15 2,15 2,15 2,15 
2,15 2,15 2,15 2,15 2,15 2,15 2,15 2,15 2,15 2,15 2,15 2,15 2,15 2,15 2,15 2,15 2,15 2,15 2,15 2,15 2,15 2,15 2,15 2,15 2,15 
2,15 2,15 2,15 2,15 2,15 2,15 2,15 2,15 2,15 2,15 2,15 2,15 2,15 2,15 2,15 2,15 2,15 2,15 2,15 2,15 2,15 2,15 2,15 2,15 2,15 
2,15 2,15 2,15 2,15 2,15 2,15 2,15 2,15 2,15 2,15 2,15 2,15 2,15 2,15 2,15 2,15 2,15 2,15 2,15 2,15 2,15 2,15 2,15 2,15 2,15 
2,15 2,15 2,15 2,15 2,15 2,15 2,15 2,15 2,15 2,15 2,15 2,15 2,15 2,15 2,15 2,15 2,15 2,15 2,15 2,15 2,15 2,15 2,15 2,15 2,15 
2,15 2,15 2,15 2,15 2,15 2,15 2,15 2,15 2,15 2,15 2,15 2,15 2,15 2,15 2,15 2,15 2,15 2,15 2,15 2,15 2,15 2,15 2,15 2,15 2,15 
2,15 2,15 2,15 2,15 2,15 2,15 2,15 2,15 2,15 2,15 2,15 2,15 2,15 2,15 2,15 2,15 2,15 2,15 2,15 2,15 2,15 2,15 2,15 2,15 2,15 
2,15 2,15 2,15 2,15 2,15 2,15 2,15 2,15 2,15 2,15 2,15 2,15 2,15 2,15 2,15 2,15 2,15 2,15 2,15 2,15 2,15 2,15 2,15 2,15 2,15 
z
2,15 2,15 2,15 2,15 2,15 2,15 2,15 2,15 2,15 2,15 2,15 2,15 2,15 2,15 2,15 2,15 2,15 2,15 2,15 2,15 2,15 2,15 2,15 2,15 2,15 
2,15 1,15 1,15 1,15 1,15 1,15 1,15 1,15 3,15 1,15 1,15 1,15 1,15 1,15 2,15 1,15 2,15 1,15 1,15 1,15 2,15 1,15 1,15 1,15 2,15 
2,15 1,15 1,15 1,15 2,15 1,15 2,15 2,15 1,15 1,15 2,15 2,15 2,15 1,15 1,15 1,15 2,15 1,15 2,15 1,15 2,15 1,15 2,15 2,15 2,15 
2,15 1,15 1,15 1,15 2,15 1,15 2,9 1,15 1,15 1,15 1,15 1,15 1,15 1,15 2,15 1,15 2,15 1,15 2,15 1,15 2,15 1,15 2,15 1,15 2,15 
2,15 2,15 2,15 2,15 2,15 2,9 2,9 2,9 2,15 1,15 1,15 2,15 2,15 1,15 2,15 1,15 1,15 1,15 2,15 1,15 1,15 1,15 2,15 1,15 2,15 
2,15 2,15 2,15 2,15 2,9 2,9 2,9 2,9 2,9 1,15 1,15 1,15 1,15 1,15 2,15 2,15 2,15 1,15 2,15 1,15 2,15 1,15 2,15 1,15 2,15 
2,15 1,15 2,15 2,15 2,15 2,9 2,9 2,9 2,15 2,15 2,15 1,15 2,15 1,15 2,15 1,15 2,15 1,15 2,15 1,15 2,15 1,15 2,15 2,15 2,15 
2,15 1,15 2,15 2,15 1,15 2,15 2,9 2,15 2,15 2,15 2,15 4,15 1,15 1,15 2,15 1,15 1,15 1,15 2,15 1,15 2,15 1,15 1,15 1,15 2,15 
2,15 2,15 2,15 2,15 2,15 2,15 2,15 2,15 2,15 1,15 2,15 2,15 2,15 2,15 2,15 2,15 2,15 2,15 2,15 2,15 2,15 2,15 2,15 2,15 2,15 
2,15 2,15 2,15 4,15 2,15 2,15 2,15 2,15 2,15 1,15 1,15 1,15 1,15 1,15 1,15 1,15 1,15 1,15 1,15 1,15 1,15 1,15 1,15 1,15 2,15 
2,15 2,15 2,15 1,15 2,15 1,15 2,15 2,15 2,15 2,15 2,15 2,15 2,15 2,15 2,15 2,15 2,15 1,15 2,15 2,15 2,15 2,15 2,15 2,15 2,15 
2,15 1,15 2,15 1,15 2,15 1,15 1,15 1,15 2,15 1,15 2,15 2,15 2,15 2,15 2,15 2,15 2,15 1,15 2,15 1,15 2,15 2,15 2,15 2,15 2,15 
2,15 1,15 2,15 1,15 2,15 1,15 1,15 1,15 2,15 1,15 2,15 1,15 1,15 1,15 1,15 1,15 2,15 1,15 2,15 1,15 2,15 2,15 2,15 2,15 2,15 
2,15 1,15 2,15 1,15 2,15 1,15 1,15 1,15 2,15 1,15 2,15 1,15 1,15 1,15 1,15 1,15 2,15 1,15 2,15 1,15 2,15 2,15 2,15 2,15 2,15 
2,15 2,15 2,15 2,15 2,15 2,15 2,15 2,15 2,15 2,15 2,15 2,15 2,15 2,15 2,15 1,15 2,15 1,15 1,15 1,15 2,15 2,15 2,15 2,15 2,15 
2,15 1,15 1,15 1,15 2,15 2,15 2,15 2,15 2,15 1,15 1,15 1,15 2,15 2,15 2,15 1,15 2,15 1,15 2,15 1,15 2,15 2,15 2,15 2,15 2,15 
2,15 1,15 1,15 1,15 2,15 2,15 2,15 2,15 2,15 1,15 1,15 1,15 1,15 1,15 2,15 1,15 2,15 1,15 2,15 1,15 2,15 2,15 2,15 2,15 2,15 
2,15 1,15 1,15 1,15 2,15 2,15 2,15 2,15 2,15 1,15 1,15 1,15 2,15 1,15 1,15 1,15 1,15 1,15 2,15 1,15 2,15 2,15 2,15 2,15 2,15 
2,15 2,15 1,15 2,15 2,15 2,15 2,15 2,15 2,15 2,15 2,15 2,15 2,15 2,15 2,15 1,15 2,15 1,15 2,15 1,15 2,15 2,15 2,15 2,15 2,15 
2,15 2,15 1,15 1,15 2,15 2,15 2,15 2,15 2,15 1,15 2,15 2,15 2,15 2,15 2,15 1,15 2,15 1,15 2,15 1,15 2,15 2,15 2,15 2,15 2,15 
2,15 2,15 2,15 1,15 2,15 2,15 2,15 2,15 2,15 1,15 1,15 1,15 1,15 1,15 1,15 1,15 2,15 1,15 2,15 1,15 2,15 2,15 2,15 2,15 2,15 
2,15 1,15 2,15 1,15 2,15 2,15 2,15 2,15 2,15 2,15 2,15 2,15 2,15 1,15 2,15 2,15 2,15 1,15 2,15 1,15 2,15 2,15 2,15 2,15 2,15 
2,15 1,15 1,15 1,15 1,15 1,15 1,15 1,15 1,15 1,15 1,15 1,15 1,15 1,15 1,15 2,15 1,15 1,15 2,15 2,15 2,15 2,15 2,15 2,15 2,15 
2,15 2,15 2,15 2,15 1,15 2,15 2,15 2,15 2,15 2,15 2,15 2,15 2,15 2,15 2,15 2,15 2,15 2,15 2,15 2,15 2,15 2,15 2,15 2,15 2,15 
2,15 2,15 2,15 2,15 2,15 2,15 2,15 2,15 2,15 2,15 2,15 2,15 2,15 2,15 2,15 2,15 2,15 2,15 2,15 2,15 2,15 2,15 2,15 2,15 2,15 
z
2,15 2,15 2,15 2,15 2,15 6,15 6,15 6,15 2,15 2,15 2,15 2,15 2,15 2,15 2,15 2,15 2,15 2,15 2,15 2,15 2,15 2,15 2,15 2,15 2,15 
2,15 2,15 2,15 3,15 1,15 1,15 1,15 1,15 2,15 2,15 1,15 2,15 1,15 1,15 1,15 2,15 1,15 1,15 1,15 1,15 2,15 1,15 1,15 1,15 2,15 
2,15 2,15 2,15 2,15 1,15 2,15 1,15 1,15 3,15 2,15 1,15 2,15 1,15 1,15 1,15 2,15 1,15 2,15 2,15 1,15 2,15 1,15 2,15 1,15 2,15 
2,15 2,15 2,15 2,15 2,5 2,5 1,15 2,5 2,5 6,15 6,15 6,15 1,15 1,15 1,15 1,15 1,15 2,15 2,15 1,15 2,15 1,15 1,15 1,15 2,15 
2,15 1,15 1,15 1,15 2,5 1,15 1,15 1,15 4,5 6,15 6,15 6,15 6,15 1,15 1,15 2,15 2,15 2,15 2,15 1,15 6,15 1,15 2,15 1,15 2,15 
2,15 1,15 6,15 1,15 1,15 1,15 7,15 1,15 1,15 1,15 1,15 1,15 6,15 1,15 1,15 2,15 1,15 1,15 2,15 1,15 2,15 1,15 1,15 1,15 2,15 
2,15 1,15 1,15 1,15 2,5 1,15 1,15 1,15 2,5 1,15 6,15 2,15 2,15 2,15 2,15 2,15 2,15 1,15 2,15 1,15 2,15 1,15 2,15 1,15 2,15 
2,15 2,15 6,15 2,15 2,5 2,5 5,5 2,5 2,5 1,15 1,15 3,15 2,15 2,15 2,15 2,15 2,15 1,15 2,15 2,15 2,15 1,15 1,15 1,15 2,15 
2,15 1,15 1,15 1,15 1,15 1,15 1,15 1,15 1,15 1,15 1,15 1,15 1,15 1,15 1,15 1,15 1,15 1,15 1,15 1,15 2,15 1,15 2,15 1,15 2,15 
2,15 1,15 2,15 3,15 2,15 2,15 5,15 2,15 2,15 2,15 2,15 2,15 2,15 2,15 2,15 2,15 2,15 2,15 2,15 1,15 2,15 1,15 1,15 1,15 2,15 
2,15 1,15 2,15 2,15 2,15 1,15 1,15 1,15 1,15 1,15 1,15 1,15 1,15 1,15 1,15 1,15 1,15 1,15 2,15 1,15 2,15 1,15 2,15 1,15 2,15 
2,15 1,15 2,15 2,15 2,15 1,15 1,15 1,15 2,15 1,15 2,15 2,15 2,15 2,15 2,15 2,15 2,15 1,15 2,15 1,15 2,15 1,15 1,15 1,15 2,15 
2,15 1,15 2,15 2,15 2,15 1,15 1,15 1,15 2,15 1,15 2,15 1,15 1,15 1,15 1,15 1,15 2,15 1,15 2,15 1,15 2,15 1,15 2,15 1,15 2,15 
2,15 1,15 2,15 2,15 2,15 1,15 1,15 1,15 2,15 1,15 2,15 1,15 1,15 1,15 1,15 1,15 2,15 1,15 2,15 1,15 2,15 1,15 1,15 1,15 2,15 
2,15 2,15 2,15 2,15 2,15 2,15 5,15 2,15 2,15 2,15 2,15 2,15 2,15 2,15 2,15 1,15 2,15 1,15 1,15 1,15 2,15 1,15 2,15 1,15 2,15 
2,15 1,15 1,15 1,15 2,15 2,15 1,15 1,15 6,15 1,15 1,15 1,15 2,15 2,15 2,15 1,15 2,15 1,15 2,15 1,15 2,15 1,15 1,15 1,15 2,15 
2,15 1,15 1,15 1,15 2,15 2,15 1,15 1,15 2,15 1,15 1,15 1,15 1,15 1,15 2,15 1,15 2,15 1,15 2,15 1,15 6,15 1,15 2,15 1,15 2,15 
2,15 1,15 1,15 1,15 2,15 1,15 1,15 2,15 6,15 1,15 1,15 1,15 2,15 1,15 1,15 1,15 1,15 1,15 2,15 1,15 2,15 1,15 1,15 1,15 2,15 
2,15 2,15 1,15 2,15 2,15 1,15 2,15 2,15 2,15 2,15 2,15 2,15 2,15 2,15 2,15 1,15 2,15 1,15 2,15 1,15 2,15 2,15 4,15 2,15 2,15 
2,15 2,15 1,15 1,15 2,15 2,15 2,15 2,15 2,15 1,15 2,15 2,15 2,15 2,15 2,15 1,15 2,15 1,15 2,15 1,15 2,15 2,15 2,15 2,15 2,15 
2,15 2,15 2,15 1,15 2,15 2,15 2,15 2,15 2,15 1,15 1,15 1,15 1,15 1,15 1,15 1,15 2,15 1,15 2,15 1,15 2,15 2,15 2,15 2,15 2,15 
2,15 1,15 2,15 1,15 2,15 2,15 2,15 2,15 2,15 2,15 2,15 2,15 2,15 1,15 2,15 2,15 2,15 1,15 2,15 1,15 2,15 2,15 2,15 2,15 2,15 
2,15 1,15 1,15 1,15 1,15 1,15 1,15 1,15 1,15 1,15 1,15 1,15 1,15 1,15 1,15 2,15 1,15 1,15 2,15 2,15 2,15 2,15 2,15 2,15 2,15 
2,15 2,15 2,15 2,15 1,15 2,15 2,15 2,15 2,15 2,15 2,15 2,15 2,15 2,15 2,15 2,15 2,15 2,15 2,15 2,15 2,15 2,15 2,15 2,15 2,15 
2,15 2,15 2,15 2,15 2,15 2,15 2,15 2,15 2,15 2,15 2,15 2,15 2,15 2,15 2,15 2,15 2,15 2,15 2,15 2,15 2,15 2,15 2,15 2,15 2,15 
z
2,15 2,15 2,15 2,15 2,15 2,15 2,15 2,15 2,15 2,15 2,15 2,15 2,15 2,15 2,15 2,15 2,15 2,15 2,15 2,15 2,15 2,15 2,15 2,15 2,15 
2,15 2,15 2,15 2,15 2,15 2,15 2,15 2,15 2,15 2,15 2,15 2,15 2,15 2,15 2,15 2,15 2,15 2,15 2,15 2,15 2,15 2,15 2,15 2,15 2,15 
2,15 2,15 2,15 2,15 2,15 2,15 2,15 2,15 2,15 1,15 1,15 2,15 2,15 2,15 2,15 2,15 2,15 2,15 2,15 2,15 2,15 2,15 2,15 2,15 2,15 
2,15 2,15 2,15 2,15 2,15 2,15 2,5 2,15 2,15 1,15 1,15 2,15 2,15 2,15 2,15 2,15 2,15 2,15 2,15 2,15 2,15 2,15 2,15 2,15 2,15 
2,15 2,15 2,15 2,15 2,15 2,5 2,5 2,5 3,15 1,15 1,15 1,15 2,15 2,15 2,15 2,15 2,15 2,15 2,15 2,15 2,15 2,15 2,15 2,15 2,15 
2,15 2,15 2,15 2,15 2,5 2,5 2,5 2,5 2,5 2,15 2,15 2,15 2,15 2,15 2,15 2,15 2,15 2,15 2,15 2,15 2,15 2,15 2,15 2,15 2,15 
2,15 2,15 2,15 2,15 2,15 2,5 2,5 2,5 2,15 2,15 2,15 2,15 2,15 2,15 2,15 2,15 2,15 2,15 2,15 2,15 2,15 2,15 2,15 2,15 2,15 
2,15 2,15 2,15 2,15 2,15 2,15 2,5 2,15 2,15 2,15 2,15 2,15 2,15 2,15 2,15 2,15 2,15 2,15 2,15 2,15 2,15 2,15 2,15 2,15 2,15 
2,15 2,15 2,15 2,15 2,15 2,15 2,15 2,15 2,15 2,15 2,15 2,15 2,15 2,15 2,15 2,15 2,15 2,15 2,15 2,15 2,15 2,15 2,15 2,15 2,15 
2,15 2,15 2,15 2,15 2,15 2,15 2,15 2,15 2,15 2,15 2,15 2,15 2,15 2,15 2,15 2,15 2,15 2,15 2,15 2,15 2,15 2,15 2,15 2,15 2,15 
2,15 2,15 2,15 2,15 2,15 2,15 2,15 2,15 2,15 2,15 2,15 2,15 2,15 2,15 2,15 2,15 2,15 2,15 2,15 2,15 2,15 2,15 2,15 2,15 2,15 
2,15 2,15 2,15 2,15 2,15 2,15 2,15 2,15 2,15 2,15 2,15 2,15 2,15 2,15 2,15 2,15 2,15 2,15 2,15 2,15 2,15 2,15 2,15 2,15 2,15 
2,15 2,15 2,15 2,15 2,15 2,15 2,15 2,15 2,15 2,15 2,15 2,15 2,15 2,15 2,15 2,15 2,15 2,15 2,15 2,15 2,15 2,15 2,15 2,15 2,15 
2,15 2,15 2,15 2,15 2,15 2,15 2,15 2,15 2,15 2,15 2,15 2,15 2,15 2,15 2,15 2,15 2,15 2,15 2,15 2,15 2,15 2,15 2,15 2,15 2,15 
2,15 2,15 2,15 2,15 1,15 2,15 2,15 2,15 1,15 1,15 1,15 1,15 1,15 1,15 1,15 2,15 1,15 2,15 2,15 2,15 1,15 2,15 2,15 2,15 2,15 
2,15 2,15 2,15 2,15 1,15 2,15 2,15 2,15 1,15 2,15 2,15 2,15 1,15 1,15 1,15 2,15 1,15 2,15 1,15 2,15 1,15 2,15 2,15 2,15 2,15 
2,15 2,15 2,15 2,15 1,15 2,15 2,15 2,15 1,15 2,15 2,15 2,15 2,15 2,15 1,15 2,15 1,15 2,15 1,15 2,15 1,15 2,15 2,15 2,15 2,15 
2,15 2,15 2,15 2,15 2,15 1,15 2,15 2,15 2,15 2,15 2,15 2,15 1,15 2,15 2,15 2,15 2,15 2,15 1,15 2,15 2,15 2,15 2,15 2,15 2,15 
2,15 1,15 2,15 1,15 2,15 1,15 2,15 2,15 2,15 1,15 1,15 1,15 1,15 1,15 1,15 2,15 1,15 2,15 1,15 2,15 2,15 4,15 3,15 2,15 2,15 
2,15 1,15 2,15 2,15 2,15 2,15 2,15 2,15 2,15 2,15 2,15 1,15 1,15 1,15 1,15 2,15 1,15 2,15 1,15 2,15 2,15 1,15 1,15 2,15 2,15 
2,15 1,15 1,15 2,15 1,15 2,15 2,15 2,15 1,15 2,15 2,15 2,15 2,15 2,15 2,15 2,15 1,15 2,15 1,15 2,15 2,15 2,15 2,15 2,15 2,15 
2,15 2,15 1,15 2,15 1,15 2,15 1,15 1,15 1,15 1,15 1,15 1,15 1,15 2,15 1,15 2,15 1,15 2,15 1,15 2,15 1,15 1,15 1,15 1,15 2,15 
2,15 2,15 2,15 2,15 2,15 2,15 2,15 2,15 2,15 2,15 2,15 2,15 2,15 2,15 2,15 1,15 2,15 2,15 1,15 2,15 1,15 1,15 1,15 1,15 2,15 
2,15 1,15 1,15 1,15 2,15 2,15 2,15 2,15 2,15 1,15 1,15 1,15 1,15 1,15 1,15 1,15 1,15 2,15 1,15 2,15 1,15 1,15 1,15 1,15 2,15 
2,15 2,15 2,15 2,15 2,15 2,15 2,15 2,15 2,15 2,15 2,15 2,15 2,15 2,15 2,15 2,15 2,15 2,15 2,15 2,15 2,15 2,15 2,15 2,15 2,15 
z
2,15 2,15 2,15 2,15 2,15 2,15 2,15 2,15 2,15 2,15 2,15 2,15 2,15 2,15 2,15 2,15 2,15 2,15 2,15 2,15 2,15 2,15 2,15 2,15 2,15 
2,15 1,15 1,15 1,15 1,15 1,15 1,15 1,15 1,15 1,15 1,15 1,15 1,15 1,15 1,15 1,15 1,15 1,15 1,15 1,15 1,15 1,15 1,15 1,15 2,15 
2,15 1,15 1,15 1,15 1,15 1,15 2,15 1,15 1,15 2,15 2,15 1,15 1,15 1,15 1,15 1,15 1,15 1,15 1,15 1,15 1,15 1,15 1,15 1,15 2,15 
2,15 1,15 1,15 1,15 1,15 1,15 3,15 1,15 1,15 2,15 2,15 1,15 1,15 1,15 1,15 1,15 1,15 1,15 1,15 1,15 1,15 1,15 1,15 1,15 2,15 
2,15 1,15 1,15 1,15 1,15 1,15 4,15 1,15 1,15 2,15 2,15 2,15 1,15 1,15 1,15 1,15 1,15 1,15 1,15 1,15 1,15 1,15 1,15 1,15 2,15 
2,15 1,15 1,15 1,15 1,15 1,15 5,15 1,15 2,15 2,15 2,15 1,15 1,15 1,15 1,15 1,15 1,15 1,15 1,15 1,15 1,15 1,15 1,15 1,15 2,15 
2,15 1,15 1,15 1,15 1,15 1,15 6,15 1,15 1,15 1,15 1,15 1,15 1,15 1,15 1,15 1,15 1,15 1,15 1,15 1,15 1,15 1,15 1,15 1,15 2,15 
2,15 1,15 1,15 1,15 1,15 1,15 1,15 1,15 1,15 1,15 1,15 1,15 1,15 1,15 1,15 1,15 1,15 1,15 1,15 1,15 1,15 1,15 1,15 1,15 2,15 
2,15 1,15 1,15 1,15 1,15 1,15 2,15 1,15 1,15 1,15 1,15 1,15 1,15 1,15 1,15 1,15 1,15 1,15 1,15 1,15 1,15 1,15 1,15 1,15 2,15 
2,15 1,15 1,15 1,15 1,15 1,15 2,15 1,15 1,15 1,15 1,15 1,15 1,15 1,15 1,15 1,15 1,15 1,15 1,15 1,15 1,15 1,15 1,15 1,15 2,15 
2,15 1,15 1,15 1,15 1,15 1,15 1,15 1,15 1,15 1,15 1,15 1,15 1,15 1,15 1,15 1,15 1,15 1,15 1,15 1,15 1,15 1,15 1,15 1,15 2,15 
2,15 1,15 1,15 1,15 1,15 1,15 1,15 1,15 1,15 1,15 1,15 1,15 1,15 1,15 1,15 1,15 1,15 1,15 1,15 1,15 1,15 1,15 1,15 1,15 2,15 
2,15 1,15 1,15 1,15 1,15 1,15 1,15 1,15 1,15 1,15 1,15 1,15 1,15 1,15 1,15 1,15 1,15 1,15 1,15 1,15 1,15 1,15 1,15 1,15 2,15 
2,15 1,15 1,15 1,15 1,15 1,15 1,15 1,15 1,15 1,15 1,15 1,15 1,15 1,15 1,15 1,15 1,15 1,15 1,15 1,15 1,15 1,15 1,15 1,15 2,15 
2,15 1,15 1,15 1,15 1,15 1,15 1,15 1,15 1,15 1,15 1,15 1,15 1,15 1,15 1,15 1,15 1,15 1,15 1,15 1,15 1,15 1,15 1,15 1,15 2,15 
2,15 1,15 1,15 1,15 1,15 1,15 1,15 1,15 1,15 1,15 1,15 1,15 1,15 1,15 1,15 1,15 1,15 1,15 1,15 1,15 1,15 1,15 1,15 1,15 2,15 
2,15 1,15 1,15 1,15 1,15 2,15 2,15 2,15 1,15 1,15 1,15 1,15 1,15 1,15 1,15 1,15 1,15 1,15 1,15 1,15 2,15 2,15 2,15 2,15 2,15 
2,15 1,15 1,15 1,15 2,15 2,15 2,15 2,15 2,15 1,15 1,15 1,15 1,15 1,15 1,15 1,15 1,15 1,15 1,15 1,15 2,15 1,15 1,15 2,15 2,15 
2,15 1,15 1,15 1,15 2,15 1,15 2,15 2,15 2,15 1,15 1,15 1,15 1,15 1,15 1,15 1,15 1,15 1,15 1,15 1,15 2,15 3,15 4,15 2,15 2,15 
2,15 1,15 1,15 1,15 2,15 1,15 1,15 1,15 2,15 1,15 1,15 1,15 1,15 1,15 1,15 1,15 1,15 1,15 1,15 1,15 2,15 2,15 2,15 2,15 2,15 
2,15 1,15 1,15 1,15 1,15 2,15 2,15 2,15 1,15 1,15 1,15 1,15 1,15 1,15 1,15 1,15 1,15 1,15 1,15 1,15 2,15 2,15 2,15 2,15 2,15 
2,15 1,15 1,15 1,15 1,15 1,15 1,15 1,15 1,15 1,15 1,15 1,15 1,15 1,15 1,15 1,15 1,15 1,15 1,15 1,15 1,15 1,15 1,15 1,15 2,15 
2,15 1,15 1,15 1,15 1,15 1,15 1,15 1,15 1,15 1,15 1,15 1,15 1,15 1,15 1,15 1,15 1,15 1,15 1,15 1,15 1,15 1,15 1,15 1,15 2,15 
2,15 1,15 1,15 1,15 1,15 1,15 1,15 1,15 1,15 1,15 1,15 1,15 1,15 1,15 1,15 1,15 1,15 1,15 1,15 1,15 1,15 1,15 1,15 1,15 2,15 
2,15 2,15 2,15 2,15 2,15 2,15 2,15 2,15 2,15 2,15 2,15 2,15 2,15 2,15 2,15 2,15 2,15 2,15 2,15 2,15 2,15 2,15 2,15 2,15 2,15 
z
2,15 2,15 2,15 2,15 2,15 2,15 2,15 2,15 2,15 2,15 2,15 2,15 2,15 2,15 2,15 2,15 2,15 2,15 2,15 2,15 2,15 2,15 2,15 2,15 2,15 
2,15 1,15 1,15 1,15 1,15 1,15 1,15 1,15 1,15 1,15 1,15 1,15 1,15 1,15 1,15 1,15 1,15 1,15 1,15 1,15 1,15 1,15 1,15 1,15 2,15 
2,15 1,15 1,15 1,15 1,15 1,15 2,15 1,15 1,15 1,15 1,15 1,15 1,15 1,15 1,15 1,15 1,15 1,15 1,15 1,15 1,15 1,15 1,15 1,15 2,15 
2,15 1,15 1,15 1,15 1,15 1,15 3,15 1,15 1,15 1,15 1,15 1,15 1,15 1,15 1,15 1,15 1,15 1,15 1,15 1,15 1,15 1,15 1,15 1,15 2,15 
2,15 1,15 1,15 1,15 1,15 1,15 4,15 1,15 1,15 1,15 1,15 1,15 6,15 6,15 1,15 6,15 6,15 6,15 1,15 1,15 1,15 1,15 1,15 1,15 2,15 
2,15 1,15 1,15 1,15 1,15 1,15 5,15 1,15 1,15 1,15 1,15 1,15 1,15 1,15 1,15 1,15 1,15 1,15 1,15 6,15 1,15 1,15 1,15 1,15 2,15 
2,15 1,15 1,15 1,15 1,15 1,15 6,15 1,15 1,15 1,15 1,15 1,15 1,15 1,15 1,15 1,15 1,15 1,15 1,15 6,15 1,15 1,15 1,15 1,15 2,15 
2,15 1,15 1,15 1,15 1,15 1,15 1,15 1,15 1,15 1,15 1,15 1,15 1,15 1,15 1,15 1,15 1,15 1,15 1,15 6,15 1,15 1,15 1,15 1,15 2,15 
2,15 1,15 1,15 1,15 1,15 1,15 2,15 1,15 1,15 1,15 1,15 1,15 1,15 1,15 1,15 1,15 1,15 1,15 1,15 1,15 1,15 1,15 1,15 1,15 2,15 
2,15 1,15 1,15 1,15 1,15 1,15 2,15 1,15 1,15 1,15 1,15 1,15 1,15 1,15 1,15 1,15 1,15 1,15 1,15 6,15 1,15 1,15 1,15 1,15 2,15 
2,15 1,15 1,15 1,15 1,15 1,15 1,15 1,15 1,15 1,15 1,15 1,15 6,15 1,15 6,15 6,15 1,15 1,15 1,15 6,15 1,15 1,15 1,15 1,15 2,15 
2,15 1,15 1,15 1,15 1,15 1,15 1,15 1,15 1,15 1,15 1,15 1,15 1,15 1,15 1,15 1,15 6,15 1,15 6,15 1,15 1,15 1,15 1,15 1,15 2,15 
2,15 1,15 1,15 1,15 1,15 1,15 1,15 1,15 1,15 1,15 1,15 1,15 1,15 1,15 1,15 1,15 1,15 1,15 1,15 1,15 1,15 1,15 1,15 1,15 2,15 
2,15 1,15 1,15 1,15 1,15 1,15 1,15 1,15 1,15 1,15 1,15 1,15 1,15 1,15 1,15 1,15 1,15 1,15 1,15 1,15 1,15 1,15 1,15 1,15 2,15 
2,15 1,15 1,15 1,15 1,15 1,15 1,15 1,15 1,15 1,15 1,15 1,15 1,15 1,15 1,15 1,15 1,15 1,15 1,15 1,15 1,15 1,15 1,15 1,15 2,15 
2,15 1,15 1,15 1,15 1,15 1,15 1,15 1,15 1,15 1,15 1,15 1,15 1,15 1,15 1,15 1,15 1,15 1,15 1,15 1,15 1,15 1,15 1,15 1,15 2,15 
2,15 1,15 1,15 1,15 1,15 2,15 2,15 2,15 1,15 1,15 1,15 1,15 1,15 1,15 1,15 1,15 1,15 1,15 1,15 1,15 2,15 2,15 2,15 2,15 2,15 
2,15 1,15 1,15 1,15 2,15 2,15 2,15 2,15 2,15 1,15 1,15 1,15 1,15 1,15 1,15 1,15 1,15 1,15 1,15 1,15 2,15 2,15 2,15 2,15 2,15 
2,15 1,15 1,15 1,15 2,15 2,15 2,15 2,15 2,15 1,15 1,15 1,15 1,15 1,15 1,15 1,15 1,15 1,15 1,15 1,15 2,15 4,15 3,15 2,15 2,15 
2,15 1,15 1,15 1,15 2,15 1,15 1,15 1,15 2,15 1,15 1,15 1,15 1,15 1,15 1,15 1,15 1,15 1,15 1,15 1,15 2,15 1,15 1,15 2,15 2,15 
2,15 1,15 1,15 1,15 1,15 2,15 2,15 2,15 1,15 1,15 1,15 1,15 1,15 1,15 1,15 1,15 1,15 1,15 1,15 1,15 2,15 2,15 2,15 2,15 2,15 
2,15 1,15 1,15 1,15 1,15 1,15 1,15 1,15 1,15 1,15 1,15 1,15 1,15 1,15 1,15 1,15 1,15 1,15 1,15 1,15 1,15 1,15 1,15 1,15 2,15 
2,15 1,15 1,15 1,15 1,15 1,15 1,15 1,15 1,15 1,15 1,15 1,15 1,15 1,15 1,15 1,15 1,15 1,15 1,15 1,15 1,15 1,15 1,15 1,15 2,15 
2,15 1,15 1,15 1,15 1,15 1,15 1,15 1,15 1,15 1,15 1,15 1,15 1,15 1,15 1,15 1,15 1,15 1,15 1,15 1,15 1,15 1,15 1,15 1,15 2,15 
2,15 2,15 2,15 2,15 2,15 2,15 2,15 2,15 2,15 2,15 2,15 2,15 2,15 2,15 2,15 2,15 2,15 2,15 2,15 2,15 2,15 2,15 2,15 2,15 2,15 
z
2,15 2,15 2,15 2,15 2,15 2,15 2,15 2,15 2,15 2,15 2,15 2,15 2,15 2,15 2,15 2,15 2,15 2,15 2,15 2,15 2,15 2,15 2,15 2,15 2,15 
2,15 1,15 1,15 1,15 1,15 1,15 1,15 1,15 1,15 1,15 1,15 1,15 1,15 1,15 1,15 1,15 1,15 1,15 1,15 1,15 1,15 1,15 1,15 1,15 2,15 
2,15 1,15 1,15 1,15 1,15 1,15 2,15 1,15 1,15 1,15 1,15 1,15 1,15 1,15 1,15 1,15 1,15 1,15 1,15 1,15 1,15 1,15 1,15 1,15 2,15 
2,15 1,15 1,15 1,15 1,15 1,15 3,15 1,15 1,15 1,15 1,15 1,15 1,15 1,15 1,15 1,15 1,15 1,15 1,15 1,15 1,15 1,15 1,15 1,15 2,15 
2,15 1,15 1,15 1,15 1,15 1,15 4,15 1,15 1,15 1,15 1,15 1,15 1,15 6,15 1,15 6,15 1,15 6,15 1,15 1,15 1,15 1,15 1,15 1,15 2,15 
2,15 1,15 1,15 1,15 1,15 1,15 5,15 1,15 1,15 1,15 1,15 1,15 1,15 1,15 1,15 1,15 1,15 1,15 1,15 6,15 1,15 1,15 1,15 1,15 2,15 
2,15 1,15 1,15 1,15 1,15 1,15 6,15 1,15 1,15 1,15 1,15 1,15 1,15 1,15 1,15 1,15 1,15 1,15 1,15 1,15 1,15 1,15 1,15 1,15 2,15 
2,15 1,15 1,15 1,15 1,15 1,15 1,15 1,15 1,15 1,15 1,15 1,15 1,15 1,15 1,15 1,15 1,15 1,15 1,15 6,15 1,15 1,15 1,15 1,15 2,15 
2,15 1,15 1,15 1,15 1,15 1,15 2,15 1,15 1,15 1,15 1,15 1,15 1,15 1,15 1,15 1,15 1,15 1,15 1,15 1,15 1,15 1,15 1,15 1,15 2,15 
2,15 1,15 1,15 1,15 1,15 1,15 2,15 1,15 1,15 1,15 1,15 1,15 1,15 1,15 1,15 1,15 1,15 1,15 1,15 6,15 1,15 1,15 1,15 1,15 2,15 
2,15 1,15 1,15 1,15 1,15 1,15 1,15 1,15 1,15 1,15 1,15 1,15 6,15 1,15 6,15 1,15 1,15 1,15 1,15 1,15 1,15 1,15 1,15 1,15 2,15 
2,15 1,15 1,15 1,15 1,15 1,15 1,15 1,15 1,15 1,15 1,15 1,15 1,15 1,15 1,15 1,15 6,15 1,15 6,15 1,15 1,15 1,15 1,15 1,15 2,15 
2,15 1,15 1,15 1,15 1,15 1,15 1,15 1,15 1,15 1,15 1,15 1,15 1,15 1,15 1,15 1,15 1,15 1,15 1,15 1,15 1,15 1,15 1,15 1,15 2,15 
2,15 1,15 1,15 1,15 1,15 1,15 1,15 1,15 1,15 1,15 1,15 1,15 1,15 1,15 1,15 1,15 1,15 1,15 1,15 1,15 1,15 1,15 1,15 1,15 2,15 
2,15 1,15 1,15 1,15 1,15 1,15 1,15 1,15 1,15 1,15 1,15 1,15 1,15 1,15 1,15 1,15 1,15 1,15 1,15 1,15 1,15 1,15 1,15 1,15 2,15 
2,15 1,15 1,15 1,15 1,15 1,15 1,15 1,15 1,15 1,15 1,15 1,15 1,15 1,15 1,15 1,15 1,15 1,15 1,15 1,15 1,15 1,15 1,15 1,15 2,15 
2,15 1,15 1,15 1,15 1,15 2,15 2,15 2,15 1,15 1,15 1,15 1,15 1,15 1,15 1,15 1,15 1,15 1,15 1,15 1,15 2,15 2,15 2,15 2,15 2,15 
2,15 1,15 1,15 1,15 2,15 2,15 2,15 2,15 2,15 1,15 1,15 1,15 1,15 1,15 1,15 1,15 1,15 1,15 1,15 1,15 2,15 1,15 1,15 2,15 2,15 
2,15 1,15 1,15 1,15 2,15 2,15 2,15 2,15 2,15 1,15 1,15 1,15 1,15 1,15 1,15 1,15 1,15 1,15 1,15 1,15 2,15 3,15 4,15 2,15 2,15 
2,15 1,15 1,15 1,15 2,15 2,15 1,15 1,15 2,15 1,15 1,15 1,15 1,15 1,15 1,15 1,15 1,15 1,15 1,15 1,15 2,15 2,15 2,15 2,15 2,15 
2,15 1,15 1,15 1,15 1,15 2,15 2,15 2,15 1,15 1,15 1,15 1,15 1,15 1,15 1,15 1,15 1,15 1,15 1,15 1,15 2,15 2,15 2,15 2,15 2,15 
2,15 1,15 1,15 1,15 1,15 1,15 1,15 1,15 1,15 1,15 1,15 1,15 1,15 1,15 1,15 1,15 1,15 1,15 1,15 1,15 1,15 1,15 1,15 1,15 2,15 
2,15 1,15 1,15 1,15 1,15 1,15 1,15 1,15 1,15 1,15 1,15 1,15 1,15 1,15 1,15 1,15 1,15 1,15 1,15 1,15 1,15 1,15 1,15 1,15 2,15 
2,15 1,15 1,15 1,15 1,15 1,15 1,15 1,15 1,15 1,15 1,15 1,15 1,15 1,15 1,15 1,15 1,15 1,15 1,15 1,15 1,15 1,15 1,15 1,15 2,15 
2,15 2,15 2,15 2,15 2,15 2,15 2,15 2,15 2,15 2,15 2,15 2,15 2,15 2,15 2,15 2,15 2,15 2,15 2,15 2,15 2,15 2,15 2,15 2,15 2,15 
z
2,15 2,15 2,15 2,15 2,15 2,15 2,15 2,15 2,15 2,15 2,15 2,15 2,15 2,15 2,15 2,15 2,15 2,15 2,15 2,15 2,15 2,15 2,15 2,15 2,15 
2,15 1,15 1,15 1,15 1,15 1,15 1,15 1,15 1,15 1,15 1,15 1,15 1,15 1,15 1,15 1,15 1,15 1,15 1,15 1,15 1,15 1,15 1,15 1,15 2,15 
2,15 1,15 1,15 1,15 1,15 1,15 2,15 1,15 1,15 1,15 1,15 1,15 1,15 1,15 1,15 1,15 1,15 1,15 1,15 1,15 1,15 1,15 1,15 1,15 2,15 
2,15 1,15 1,15 1,15 1,15 1,15 2,15 1,15 1,15 1,15 1,15 1,15 1,15 1,15 1,15 1,15 1,15 1,15 1,15 1,15 1,15 1,15 1,15 1,15 2,15 
2,15 1,15 1,15 1,15 1,15 1,15 2,15 1,15 1,15 1,15 1,15 1,15 6,15 6,15 6,15 6,15 6,15 6,15 6,15 6,15 1,15 1,15 1,15 1,15 2,15 
2,15 1,15 1,15 1,15 1,15 1,15 2,15 1,15 1,15 1,15 1,15 1,15 1,15 1,15 1,15 1,15 1,15 1,15 1,15 6,15 1,15 1,15 1,15 1,15 2,15 
2,15 1,15 1,15 1,15 1,15 1,15 4,15 1,15 1,15 1,15 1,15 1,15 1,15 1,15 1,15 1,15 1,15 6,15 1,15 6,15 1,15 1,15 1,15 1,15 2,15 
2,15 1,15 1,15 1,15 1,15 1,15 2,15 1,15 1,15 1,15 1,15 1,15 1,15 1,15 1,15 1,15 1,15 6,15 1,15 6,15 1,15 1,15 1,15 1,15 2,15 
2,15 1,15 1,15 1,15 1,15 1,15 2,15 1,15 1,15 1,15 1,15 1,15 1,15 1,15 1,15 1,15 6,15 1,15 1,15 6,15 1,15 1,15 1,15 1,15 2,15 
2,15 1,15 1,15 1,15 1,15 1,15 2,15 1,15 1,15 1,15 1,15 1,15 6,15 1,15 1,15 1,15 1,15 1,15 1,15 6,15 1,15 1,15 1,15 1,15 2,15 
2,15 1,15 1,15 1,15 1,15 1,15 1,15 1,15 1,15 1,15 1,15 1,15 6,15 6,15 6,15 6,15 1,15 1,15 1,15 6,15 1,15 1,15 1,15 1,15 2,15 
2,15 1,15 1,15 1,15 1,15 1,15 1,15 1,15 1,15 1,15 1,15 1,15 1,15 1,15 1,15 1,15 6,15 6,15 6,15 6,15 1,15 1,15 1,15 1,15 2,15 
2,15 1,15 1,15 1,15 1,15 1,15 1,15 1,15 1,15 1,15 1,15 1,15 1,15 1,15 1,15 1,15 1,15 1,15 1,15 1,15 1,15 1,15 1,15 1,15 2,15 
2,15 1,15 1,15 1,15 1,15 1,15 1,15 1,15 1,15 1,15 1,15 1,15 1,15 1,15 1,15 1,15 1,15 1,15 1,15 1,15 1,15 1,15 1,15 1,15 2,15 
2,15 1,15 1,15 1,15 1,15 1,15 1,15 1,15 1,15 1,15 1,15 1,15 1,15 1,15 1,15 1,15 1,15 1,15 1,15 1,15 1,15 1,15 1,15 1,15 2,15 
2,15 1,15 1,15 1,15 1,15 1,15 1,15 1,15 1,15 1,15 1,15 1,15 1,15 1,15 1,15 1,15 1,15 1,15 1,15 1,15 1,15 1,15 1,15 1,15 2,15 
2,15 1,15 1,15 1,15 1,15 2,15 6,15 2,15 1,15 1,15 1,15 1,15 1,15 1,15 1,15 1,15 1,15 1,15 1,15 1,15 2,15 2,15 2,15 2,15 2,15 
2,15 1,15 1,15 1,15 2,15 1,15 1,15 2,15 2,15 1,15 1,15 1,15 1,15 1,15 1,15 1,15 1,15 1,15 1,15 1,15 2,15 2,15 2,15 2,15 2,15 
2,15 1,15 1,15 1,15 2,15 1,15 2,15 1,15 5,15 1,15 1,15 1,15 1,15 1,15 1,15 1,15 1,15 1,15 1,15 1,15 2,15 2,15 3,15 2,15 2,15 
2,15 1,15 1,15 1,15 2,15 2,15 2,15 1,15 2,15 1,15 1,15 1,15 1,15 1,15 1,15 1,15 1,15 1,15 1,15 1,15 2,15 2,15 1,15 2,15 2,15 
2,15 1,15 1,15 1,15 1,15 2,15 2,15 2,15 1,15 1,15 1,15 1,15 1,15 1,15 1,15 1,15 1,15 1,15 1,15 1,15 1,15 1,15 1,15 2,15 2,15 
2,15 1,15 1,15 1,15 1,15 1,15 1,15 1,15 1,15 1,15 1,15 1,15 1,15 1,15 1,15 1,15 1,15 1,15 1,15 1,15 2,15 2,15 1,15 2,15 2,15 
2,15 1,15 1,15 1,15 1,15 1,15 1,15 1,15 1,15 1,15 1,15 1,15 1,15 1,15 1,15 1,15 1,15 1,15 1,15 1,15 2,15 1,15 1,15 1,15 2,15 
2,15 1,15 1,15 1,15 1,15 1,15 1,15 1,15 1,15 1,15 1,15 1,15 1,15 1,15 1,15 1,15 1,15 1,15 1,15 1,15 2,15 1,15 1,15 1,15 2,15 
2,15 2,15 2,15 2,15 2,15 2,15 2,15 2,15 2,15 2,15 2,15 2,15 2,15 2,15 2,15 2,15 2,15 2,15 2,15 2,15 2,15 2,15 2,15 2,15 2,15 
z
2,15 2,15 2,15 2,15 2,15 2,15 2,15 2,15 2,15 2,15 2,15 2,15 2,15 2,15 2,15 2,15 2,15 2,15 2,15 2,15 2,15 2,15 2,15 2,15 2,15 
2,15 2,15 2,15 2,15 2,15 2,15 2,15 2,15 2,15 2,15 2,15 2,15 2,15 2,15 2,15 2,15 2,15 2,15 2,15 2,15 2,15 2,15 2,15 2,15 2,15 
2,15 2,15 2,15 2,15 2,15 2,15 2,15 2,15 2,15 2,15 2,15 2,15 2,15 2,15 2,15 2,15 2,15 2,15 2,15 2,15 2,15 2,15 2,15 2,15 2,15 
2,15 2,15 2,15 2,15 2,15 2,15 2,15 2,15 2,15 2,15 2,15 2,15 2,15 2,15 2,15 2,15 2,15 2,15 2,15 2,15 2,15 2,15 2,15 2,15 2,15 
2,15 2,15 2,15 2,15 2,15 2,15 2,15 2,15 2,15 2,15 2,15 2,15 2,15 2,15 2,15 2,15 2,15 2,15 2,15 2,15 2,15 2,15 2,15 2,15 2,15 
2,15 2,15 2,15 2,15 2,15 2,15 2,15 2,15 2,15 2,15 2,15 2,15 2,15 2,15 2,15 2,15 2,15 2,15 2,15 2,15 2,15 2,15 2,15 2,15 2,15 
2,15 2,15 2,15 2,15 2,15 2,15 2,15 2,15 2,15 2,15 2,15 2,15 2,15 2,15 2,15 2,15 2,15 2,15 2,15 2,15 2,15 2,15 2,15 2,15 2,15 
2,15 2,15 2,15 2,15 2,15 2,15 2,15 2,15 2,15 2,15 2,15 2,15 2,15 2,15 2,15 2,15 2,15 2,15 2,15 2,15 2,15 2,15 2,15 2,15 2,15 
2,15 2,15 2,15 2,15 2,15 2,15 2,15 2,15 2,15 2,15 2,15 2,15 2,15 2,15 2,15 2,15 2,15 2,15 2,15 2,15 2,15 2,15 2,15 2,15 2,15 
2,15 2,15 2,15 2,15 2,15 2,15 2,15 2,15 2,15 2,15 2,15 2,15 2,15 2,15 2,15 2,15 2,15 2,15 2,15 2,15 2,15 2,15 2,15 2,15 2,15 
2,15 2,15 2,15 2,15 2,15 2,15 2,15 2,15 2,15 2,15 2,15 2,15 2,15 2,15 2,15 2,15 2,15 2,15 2,15 2,15 2,15 2,15 2,15 2,15 2,15 
2,15 2,15 2,15 2,15 2,15 2,15 2,15 2,15 2,15 2,15 2,15 2,15 2,15 2,15 2,15 2,15 2,15 2,15 2,15 2,15 2,15 2,15 2,15 2,15 2,15 
2,15 2,15 2,15 2,15 2,15 2,15 2,15 2,15 2,15 2,15 2,15 2,15 2,15 2,15 2,15 2,15 2,15 2,15 2,15 2,15 2,15 2,15 2,15 2,15 2,15 
2,15 2,15 2,15 2,15 2,15 2,15 2,15 2,15 2,15 2,15 2,15 2,15 2,15 2,15 2,15 2,15 2,15 2,15 2,15 2,15 2,15 2,15 2,15 2,15 2,15 
2,15 2,15 2,15 2,15 2,15 2,15 2,15 2,15 2,15 2,15 2,15 2,15 2,15 2,15 2,15 2,15 2,15 2,15 2,15 2,15 2,15 2,15 2,15 2,15 2,15 
2,15 2,15 2,15 2,15 2,15 2,15 2,15 2,15 2,15 2,15 2,15 2,15 2,15 2,15 2,15 2,15 2,15 2,15 2,15 2,15 2,15 2,15 2,15 2,15 2,15 
2,15 2,15 2,15 2,15 2,15 2,15 2,15 2,15 2,15 2,15 2,15 2,15 2,15 2,15 2,15 2,15 2,15 2,15 2,15 2,15 2,15 2,15 2,15 2,15 2,15 
2,15 2,15 2,15 2,15 2,15 2,15 2,15 2,15 2,15 2,15 2,15 2,15 2,15 2,15 2,15 2,15 2,15 2,15 2,15 2,15 2,15 2,15 2,15 2,15 2,15 
2,15 2,15 2,15 2,15 2,15 2,15 2,15 2,15 2,15 2,15 2,15 2,15 2,15 2,15 2,15 2,15 2,15 2,15 2,15 2,15 2,15 2,15 2,15 2,15 2,15 
2,15 2,15 2,15 2,15 2,15 2,15 2,15 2,15 2,15 2,15 2,15 2,15 2,15 2,15 2,15 2,15 2,15 2,15 2,15 2,15 2,15 2,15 2,15 2,15 2,15 
2,15 2,15 2,15 2,15 2,15 2,15 2,15 2,15 2,15 2,15 2,15 2,15 2,15 2,15 2,15 2,15 2,15 2,15 2,15 2,15 2,15 2,15 2,15 2,15 2,15 
2,15 2,15 2,15 2,15 2,15 2,15 2,15 2,15 2,15 2,15 2,15 2,15 2,15 2,15 2,15 2,15 2,15 2,15 2,15 2,15 2,15 2,15 2,15 2,15 2,15 
2,15 2,15 2,15 2,15 2,15 2,15 2,15 2,15 2,15 2,15 2,15 2,15 2,15 2,15 2,15 2,15 2,15 2,15 2,15 2,15 2,15 2,15 2,15 2,15 2,15 
2,15 2,15 2,15 2,15 2,15 2,15 2,15 2,15 2,15 2,15 2,15 2,15 2,15 2,15 2,15 2,15 2,15 2,15 2,15 2,15 2,15 2,15 2,15 2,15 2,15 
2,15 2,15 2,15 2,15 2,15 2,15 2,15 2,15 2,15 2,15 2,15 2,15 2,15 2,15 2,15 2,15 2,15 2,15 2,15 2,15 2,15 2,15 2,15 2,15 2,15 
z
